██████████████████████████░░██
MG░░░░░░░░░░░░░░░░░░░░░░░░░░██
██░░██░░██░░██████░░██░░██░░██
██░░██░░██░░░░██░░░░██░░██░░██
██░░░░░░░░████████████████░░██
██░░████░░░░░░░░░░░░░░░░░░░░░░
██░░░░░░░░██████████░░░░██░░██
░░░░██████████████████░░██░░██
░░██████░░░░░░░░░░████░░██░░██
░░██GD██░░██░░██░░░░░░░░██░░██
░░██░░██░░██░░██░░████░░██░░██
░░██░░░░░░██░░██░░░░░░░░░░░░░░
░░██████░░░░░░░░░░██████░░████
░░░░░░██████████░░██████░░████
████░░░░░░░░░░░░░░░░░░░░░░░░░░
